0 0 0 0 0 0 0 0 0 0 0 0 0 0 0 0 0 0 0 0 0 0 0 0 0 0 0 0 0 0 0 0 0 0 0 0 0 0 0 0 0 0 0 0 0 0 0 0
0 0 0 0 0 0 0 0 0 0 0 0 0 0 0 0 0 0 0 0 0 0 0 0 0 0 0 0 0 0 0 0 0 0 0 0 0 0 0 0 0 0 0 0 0 0 0 0
0 0 0 0 0 0 0 0 0 0 0 0 0 0 0 0 0 0 0 0 0 0 0 0 0 0 0 0 0 0 0 0 0 0 0 0 0 0 0 0 0 0 0 0 0 0 0 0
0 0 0 0 20 20 20 20 20 20 20 20 20 20 20 20 20 20 20 20 20 20 20 20 20 20 20 20 20 20 20 20 20 20 20 20 20 20 20 20 20 20 20 20 0 0 0 0
0 0 0 0 20 8 8 8 8 8 8 8 8 8 8 8 8 8 8 8 8 8 8 8 8 8 8 8 8 8 8 8 8 8 8 8 8 8 8 8 8 8 8 20 0 0 0 0
0 0 0 0 20 8 12 12 12 12 12 12 12 12 12 12 12 12 12 12 12 12 12 12 12 12 12 12 12 12 12 12 12 12 12 12 12 12 12 12 12 12 8 20 0 0 0 0
0 0 0 0 20 8 12 20 20 20 20 20 20 20 20 20 20 20 20 20 20 4 4 4 4 4 4 4 4 4 4 4 4 4 4 4 4 4 4 4 4 12 8 4 0 0 0 0
0 0 0 0 4 8 12 4 25 25 25 25 25 25 25 25 25 25 25 25 25 25 25 25 25 25 25 25 25 25 25 25 25 25 25 25 25 25 25 25 4 12 8 4 0 0 0 0
0 0 0 0 4 8 12 4 25 6 6 6 6 6 6 6 6 6 6 6 6 6 6 6 6 6 6 6 6 6 6 6 6 6 6 6 6 6 6 25 4 12 8 4 0 0 0 0
0 0 0 0 4 8 12 4 25 6 35 35 35 35 35 35 35 35 35 35 35 35 35 35 35 35 35 35 35 35 35 35 35 35 35 35 35 35 6 25 4 12 8 4 0 0 0 0
0 0 0 0 4 8 12 4 25 6 35 6 6 6 6 6 6 6 6 6 6 6 6 6 6 6 6 6 6 6 6 6 6 6 6 6 6 35 6 25 4 12 8 4 0 0 0 0
0 0 0 0 4 8 12 4 25 6 35 6 25 25 25 25 25 25 25 25 25 25 25 25 25 25 25 25 25 25 25 25 25 25 25 25 6 35 6 25 4 12 8 4 0 0 0 0
0 0 0 0 4 8 12 4 25 6 35 6 25 4 4 4 4 4 4 4 4 4 4 4 4 4 4 4 4 4 4 4 4 4 4 25 6 35 6 25 4 12 8 4 0 0 0 0
0 0 0 0 4 8 12 4 25 6 35 6 25 4 12 12 12 12 12 12 12 12 12 12 12 12 12 12 12 12 12 12 12 12 4 25 6 35 6 25 4 12 8 4 0 0 0 0
0 0 0 0 4 8 12 4 25 6 35 6 25 4 12 8 8 8 8 8 8 8 8 8 8 8 8 8 8 8 8 8 8 12 4 25 6 35 6 25 4 12 8 4 0 0 0 0
0 0 0 0 4 8 12 4 25 6 35 6 25 4 12 8 4 4 4 4 4 4 4 4 4 4 4 4 4 4 4 4 8 12 4 25 6 35 6 25 4 12 8 4 0 0 0 0
0 0 0 0 4 8 12 4 25 6 35 6 25 4 12 8 4 -4 -4 -4 -4 -4 -4 -4 -4 -4 -4 -4 -4 -4 -4 4 8 12 4 25 6 35 6 25 4 12 8 4 0 0 0 0
0 0 0 0 4 8 12 4 25 6 35 6 25 4 12 8 4 -4 -8 -4 -4 -4 -4 -4 -8 -8 -8 -8 -8 -8 -4 4 8 12 4 25 6 35 6 25 4 12 8 4 0 0 0 0
0 0 0 0 4 8 12 4 25 6 35 6 25 4 12 8 4 -4 -8 -12 -12 -12 -12 -12 -12 -12 -12 -12 -12 -8 -4 4 8 12 4 25 6 35 6 25 4 12 8 4 0 0 0 0
0 0 0 0 4 8 12 4 25 6 35 6 25 4 12 8 4 -4 -8 -12 -4 -4 -4 -4 -4 -4 -4 -4 -12 -8 -4 4 8 12 4 25 6 35 6 25 4 12 8 4 0 0 0 
0 0 0 0 4 8 12 4 25 6 35 6 25 4 12 8 4 -4 -8 -12 -4 -20 -20 -20 -20 -20 -20 -4 -12 -8 -4 4 8 12 4 25 6 35 6 25 4 12 8 4 0 0 0 0
0 0 0 0 4 8 12 4 25 6 35 6 25 4 12 8 4 -4 -8 -12 -4 -20 -25 -25 -25 -25 -20 -4 -12 -8 -4 4 8 12 4 25 6 35 6 25 4 12 8 4 0 0 0 0
0 0 0 0 4 8 12 4 25 6 35 6 25 4 12 8 4 -4 -8 -12 -4 -20 -25 -30 -30 -25 -20 -4 -12 -8 -4 4 8 12 4 25 6 35 6 25 4 12 8 4 0 0 0 0
0 0 0 0 4 8 12 4 25 6 35 6 25 4 12 8 4 -4 -8 -12 -4 -20 -25 -30 -30 -25 -20 -4 -12 -8 -4 4 8 12 4 25 6 35 6 25 4 12 8 4 0 0 0 0
0 0 0 0 4 8 12 4 25 6 35 6 25 4 12 8 4 -4 -8 -12 -4 -20 -25 -25 -25 -25 -20 -4 -12 -8 -4 4 8 12 4 25 6 35 6 25 4 12 8 4 0 0 0 0
0 0 0 0 4 8 12 4 25 6 35 6 25 4 12 8 4 -4 -8 -12 -4 -20 -20 -20 -20 -20 -20 -4 -12 -8 -4 4 8 12 4 25 6 35 6 25 4 12 8 4 0 0 0 0
0 0 0 0 4 8 12 4 25 6 35 6 25 4 12 8 4 -4 -8 -12 -4 -4 -4 -4 -4 -4 -4 -4 -12 -8 -4 4 8 12 4 25 6 35 6 25 4 12 8 4 0 0 0 0
0 0 0 0 4 8 12 4 25 6 35 6 25 4 12 8 4 -4 -8 -12 -12 -12 -12 -12 -12 -12 -12 -12 -12 -8 -4 4 8 12 4 25 6 35 6 25 4 12 8 4 0 0 0 0
0 0 0 0 4 8 12 4 25 6 35 6 25 4 12 8 4 -4 -8 -8 -8 -8 -8 -8 -8 -8 -8 -8 -8 -8 -4 4 8 12 4 25 6 35 6 25 4 12 8 4 0 0 0 0
0 0 0 0 4 8 12 4 25 6 35 6 25 4 12 8 4 -4 -4 -4 -4 -4 -4 -4 -4 -4 -4 -4 -4 -4 -4 4 8 12 4 25 6 35 6 25 4 12 8 4 0 0 0 0
0 0 0 0 4 8 12 4 25 6 35 6 25 4 12 8 4 4 4 4 4 4 4 4 4 4 4 4 4 4 4 4 8 12 4 25 6 35 6 25 4 12 8 4 0 0 0 0
0 0 0 0 4 8 12 4 25 6 35 6 25 4 12 8 8 8 8 8 8 8 8 8 8 8 8 8 8 8 8 8 8 12 4 25 6 35 6 25 4 12 8 4 0 0 0 0
0 0 0 0 4 8 12 4 25 6 35 6 25 4 12 12 12 12 12 12 12 12 12 12 12 12 12 12 12 12 12 12 12 12 4 25 6 35 6 25 4 12 8 4 0 0 0 0
0 0 0 0 4 8 12 4 25 6 35 6 25 4 4 4 4 4 4 4 4 4 4 4 4 4 4 4 4 4 4 4 4 4 4 25 6 35 6 25 4 12 8 4 0 0 0 0
0 0 0 0 4 8 12 4 25 6 35 6 25 25 25 25 25 25 25 25 25 25 25 25 25 25 25 25 25 25 25 25 25 25 25 25 6 35 6 25 4 12 8 4 0 0 0 0
0 0 0 0 4 8 12 4 25 6 35 6 6 6 6 6 6 6 6 6 6 6 6 6 6 6 6 6 6 6 6 6 6 6 6 6 6 35 6 25 4 12 8 4 0 0 0 0
0 0 0 0 4 8 12 4 25 6 35 35 35 35 35 35 35 35 35 35 35 35 35 35 35 35 35 35 35 35 35 35 35 35 35 35 35 35 6 25 4 12 8 4 0 0 0 0
0 0 0 0 20 8 12 20 25 6 6 6 6 6 6 6 6 6 6 6 6 6 6 6 6 6 6 6 6 6 6 6 6 6 6 6 6 6 6 25 20 12 8 20 0 0 0 0
0 0 0 0 20 8 12 20 25 25 25 25 25 25 25 25 25 25 25 25 25 25 25 25 25 25 25 25 25 25 25 25 25 25 25 25 25 25 25 25 20 12 8 20 0 0 0 0
0 0 0 0 20 8 12 20 20 20 20 20 20 20 20 20 20 20 20 20 20 20 20 20 20 20 20 20 20 20 20 20 20 20 20 20 20 20 20 20 20 12 8 20 0 0 0 0
0 0 0 0 20 8 12 12 12 12 12 12 12 12 12 12 12 12 12 12 12 12 12 12 12 12 12 12 12 12 12 12 12 12 12 12 12 12 12 12 12 12 8 20 0 0 0 0
0 0 0 0 20 8 8 8 8 8 8 8 8 8 8 8 8 8 8 8 8 8 8 8 8 8 8 8 8 8 8 8 8 8 8 8 8 8 8 8 8 8 8 20 0 0 0 0
0 0 0 0 20 20 20 20 20 20 20 20 20 20 20 20 20 20 20 20 20 20 20 20 20 20 20 20 20 20 20 20 20 20 20 20 20 20 20 20 20 20 20 20 0 0 0 0
0 0 0 0 0 0 0 0 0 0 0 0 0 0 0 0 0 0 0 0 0 0 0 0 0 0 0 0 0 0 0 0 0 0 0 0 0 0 0 0 0 0 0 0 0 0 0 0
0 0 0 0 0 0 0 0 0 0 0 0 0 0 0 0 0 0 0 0 0 0 0 0 0 0 0 0 0 0 0 0 0 0 0 0 0 0 0 0 0 0 0 0 0 0 0 0
0 0 0 0 0 0 0 0 0 0 0 0 0 0 0 0 0 0 0 0 0 0 0 0 0 0 0 0 0 0 0 0 0 0 0 0 0 0 0 0 0 0 0 0 0 0 0 0
0 0 0 0 0 0 0 0 0 0 0 0 0 0 0 0 0 0 0 0 0 0 0 0 0 0 0 0 0 0 0 0 0 0 0 0 0 0 0 0 0 0 0 0 0 0 0 0
