0 0 0 0 0 0 0 0 0 0 0 0 0 0 0 0 0 0 0 0 0 0 0 0 0 0 0 0 0 0 0 0 0 0 0 0 0 0 0 0 0 0 0 0 0 0 0 0
0 0 0 0 0 0 0 0 0 0 0 0 0 0 0 0 0 0 0 0 0 0 0 0 0 0 0 0 0 0 0 0 0 0 0 0 0 0 0 0 0 0 0 0 0 0 0 0
0 0 0 0 0 0 0 0 0 0 0 0 0 0 0 0 0 0 0 0 0 0 0 0 0 0 0 0 0 0 0 0 0 0 0 0 0 0 0 0 0 0 0 0 0 0 0 0
0 0 0 0 1 1 1 1 1 1 1 1 1 1 1 1 1 1 1 1 1 1 1 1 1 1 1 1 1 1 1 1 1 1 1 1 1 1 1 1 1 1 1 1 0 0 0 0
0 0 0 0 1 5 5 5 5 5 5 5 5 5 5 5 5 5 5 5 5 5 5 5 5 5 5 5 5 5 5 5 5 5 5 5 5 5 5 5 5 5 5 1 0 0 0 0
0 0 0 0 1 5 9 9 9 9 9 9 9 9 9 9 9 9 9 9 9 9 9 9 9 9 9 9 9 9 9 9 9 9 9 9 9 9 9 9 9 9 5 1 0 0 0 0
0 0 0 0 1 5 9 12 12 12 12 12 12 12 12 12 12 12 12 12 12 12 12 12 12 12 12 12 12 12 12 12 12 12 12 12 12 12 12 12 12 9 5 1 0 0 0 0
0 0 0 0 1 5 9 12 14 14 14 14 14 14 14 14 14 14 14 14 14 14 14 14 14 14 14 14 14 14 14 14 14 14 14 14 14 14 14 14 12 9 5 1 0 0 0 0
0 0 0 0 1 5 9 12 14 17 17 17 17 17 17 17 17 17 17 17 17 17 17 17 17 17 17 17 17 17 17 17 17 17 17 17 17 17 17 14 12 9 5 1 0 0 0 0
0 0 0 0 1 5 9 12 14 17 20 20 20 20 20 20 20 20 20 20 20 20 20 20 20 20 20 20 20 20 20 20 20 20 20 20 20 20 17 14 12 9 5 1 0 0 0 0
0 0 0 0 1 5 9 12 14 17 20 17 17 17 17 17 17 17 17 17 17 17 17 17 17 17 17 17 17 17 17 17 17 17 17 17 17 20 17 14 12 9 5 1 0 0 0 0
0 0 0 0 1 5 9 12 14 17 20 17 14 14 14 14 14 14 14 14 14 14 14 14 14 14 14 14 14 14 14 14 14 14 14 14 17 20 17 14 12 9 5 1 0 0 0 0
0 0 0 0 1 5 9 12 14 17 20 17 14 12 12 12 12 12 12 12 12 12 12 12 12 12 12 12 12 12 12 12 12 12 12 14 17 20 17 14 12 9 5 1 0 0 0 0
0 0 0 0 1 5 9 12 14 17 20 17 14 12 9 9 9 9 9 9 9 9 9 9 9 9 9 9 9 9 9 9 9 9 12 14 17 20 17 14 12 9 5 1 0 0 0 0
0 0 0 0 1 5 9 12 14 17 20 17 14 12 9 5 5 5 5 5 5 5 5 5 5 5 5 5 5 5 5 5 5 9 12 14 17 20 17 14 12 9 5 1 0 0 0 0
0 0 0 0 1 5 9 12 14 17 20 17 14 12 9 5 1 1 1 1 1 1 1 1 1 1 1 1 1 1 1 1 5 9 12 14 17 20 17 14 12 9 5 1 0 0 0 0
0 0 0 0 1 5 9 12 14 17 20 17 14 12 9 5 1 -1 -1 -1 -1 -1 -1 -1 -1 -1 -1 -1 -1 -1 -1 1 5 9 12 14 17 20 17 14 12 9 5 1 0 0 0 0
0 0 0 0 1 5 9 12 14 17 20 17 14 12 9 5 1 -1 -5 -1 -1 -1 -1 -1 -5 -5 -5 -5 -5 -5 -1 1 5 9 12 14 17 20 17 14 12 9 5 1 0 0 0 0
0 0 0 0 1 5 9 12 14 17 20 17 14 12 9 5 1 -1 -5 -9 -9 -9 -9 -9 -9 -9 -9 -9 -9 -5 -1 1 5 9 12 14 17 20 17 14 12 9 5 1 0 0 0 0
0 0 0 0 1 5 9 12 14 17 20 17 14 12 9 5 1 -1 -5 -9 -12 -12 -12 -12 -12 -12 -12 -12 -9 -5 -1 1 5 9 12 14 17 20 17 14 12 9 5 1 0 0 0 
0 0 0 0 1 5 9 12 14 17 20 17 14 12 9 5 1 -1 -5 -9 -12 -14 -14 -14 -14 -14 -14 -12 -9 -5 -1 1 5 9 12 14 17 20 17 14 12 9 5 1 0 0 0 0
0 0 0 0 1 5 9 12 14 17 20 17 14 12 9 5 1 -1 -5 -9 -12 -14 -17 -17 -17 -17 -14 -12 -9 -5 -1 1 5 9 12 14 17 20 17 14 12 9 5 1 0 0 0 0
0 0 0 0 1 5 9 12 14 17 20 17 14 12 9 5 1 -1 -5 -9 -12 -14 -17 -20 -20 -17 -14 -12 -9 -5 -1 1 5 9 12 14 17 20 17 14 12 9 5 1 0 0 0 0
0 0 0 0 1 5 9 12 14 17 20 17 14 12 9 5 1 -1 -5 -9 -12 -14 -17 -20 -20 -17 -14 -12 -9 -5 -1 1 5 9 12 14 17 20 17 14 12 9 5 1 0 0 0 0
0 0 0 0 1 5 9 12 14 17 20 17 14 12 9 5 1 -1 -5 -9 -12 -14 -17 -17 -17 -17 -14 -12 -9 -5 -1 1 5 9 12 14 17 20 17 14 12 9 5 1 0 0 0 0
0 0 0 0 1 5 9 12 14 17 20 17 14 12 9 5 1 -1 -5 -9 -12 -14 -14 -14 -14 -14 -14 -12 -9 -5 -1 1 5 9 12 14 17 20 17 14 12 9 5 1 0 0 0 0
0 0 0 0 1 5 9 12 14 17 20 17 14 12 9 5 1 -1 -5 -9 -12 -12 -12 -12 -12 -12 -12 -12 -9 -5 -1 1 5 9 12 14 17 20 17 14 12 9 5 1 0 0 0 0
0 0 0 0 1 5 9 12 14 17 20 17 14 12 9 5 1 -1 -5 -9 -9 -9 -9 -9 -9 -9 -9 -9 -9 -5 -1 1 5 9 12 14 17 20 17 14 12 9 5 1 0 0 0 0
0 0 0 0 1 5 9 12 14 17 20 17 14 12 9 5 1 -1 -5 -5 -5 -5 -5 -5 -5 -5 -5 -5 -5 -5 -1 1 5 9 12 14 17 20 17 14 12 9 5 1 0 0 0 0
0 0 0 0 1 5 9 12 14 17 20 17 14 12 9 5 1 -1 -1 -1 -1 -1 -1 -1 -1 -1 -1 -1 -1 -1 -1 1 5 9 12 14 17 20 17 14 12 9 5 1 0 0 0 0
0 0 0 0 1 5 9 12 14 17 20 17 14 12 9 5 1 1 1 1 1 1 1 1 1 1 1 1 1 1 1 1 5 9 12 14 17 20 17 14 12 9 5 1 0 0 0 0
0 0 0 0 1 5 9 12 14 17 20 17 14 12 9 5 5 5 5 5 5 5 5 5 5 5 5 5 5 5 5 5 5 9 12 14 17 20 17 14 12 9 5 1 0 0 0 0
0 0 0 0 1 5 9 12 14 17 20 17 14 12 9 9 9 9 9 9 9 9 9 9 9 9 9 9 9 9 9 9 9 9 12 14 17 20 17 14 12 9 5 1 0 0 0 0
0 0 0 0 1 5 9 12 14 17 20 17 14 12 12 12 12 12 12 12 12 12 12 12 12 12 12 12 12 12 12 12 12 12 12 14 17 20 17 14 12 9 5 1 0 0 0 0
0 0 0 0 1 5 9 12 14 17 20 17 14 14 14 14 14 14 14 14 14 14 14 14 14 14 14 14 14 14 14 14 14 14 14 14 17 20 17 14 12 9 5 1 0 0 0 0
0 0 0 0 1 5 9 12 14 17 20 17 17 17 17 17 17 17 17 17 17 17 17 17 17 17 17 17 17 17 17 17 17 17 17 17 17 20 17 14 12 9 5 1 0 0 0 0
0 0 0 0 1 5 9 12 14 17 20 20 20 20 20 20 20 20 20 20 20 20 20 20 20 20 20 20 20 20 20 20 20 20 20 20 20 20 17 14 12 9 5 1 0 0 0 0
0 0 0 0 1 5 9 12 14 17 17 17 17 17 17 17 17 17 17 17 17 17 17 17 17 17 17 17 17 17 17 17 17 17 17 17 17 17 17 14 12 9 5 1 0 0 0 0
0 0 0 0 1 5 9 12 14 14 14 14 14 14 14 14 14 14 14 14 14 14 14 14 14 14 14 14 14 14 14 14 14 14 14 14 14 14 14 14 12 9 5 1 0 0 0 0
0 0 0 0 1 5 9 12 12 12 12 12 12 12 12 12 12 12 12 12 12 12 12 12 12 12 12 12 12 12 12 12 12 12 12 12 12 12 12 12 12 9 5 1 0 0 0 0
0 0 0 0 1 5 9 9 9 9 9 9 9 9 9 9 9 9 9 9 9 9 9 9 9 9 9 9 9 9 9 9 9 9 9 9 9 9 9 9 9 9 5 1 0 0 0 0
0 0 0 0 1 5 5 5 5 5 5 5 5 5 5 5 5 5 5 5 5 5 5 5 5 5 5 5 5 5 5 5 5 5 5 5 5 5 5 5 5 5 5 1 0 0 0 0
0 0 0 0 1 1 1 1 1 1 1 1 1 1 1 1 1 1 1 1 1 1 1 1 1 1 1 1 1 1 1 1 1 1 1 1 1 1 1 1 1 1 1 1 0 0 0 0
0 0 0 0 0 0 0 0 0 0 0 0 0 0 0 0 0 0 0 0 0 0 0 0 0 0 0 0 0 0 0 0 0 0 0 0 0 0 0 0 0 0 0 0 0 0 0 0
0 0 0 0 0 0 0 0 0 0 0 0 0 0 0 0 0 0 0 0 0 0 0 0 0 0 0 0 0 0 0 0 0 0 0 0 0 0 0 0 0 0 0 0 0 0 0 0
0 0 0 0 0 0 0 0 0 0 0 0 0 0 0 0 0 0 0 0 0 0 0 0 0 0 0 0 0 0 0 0 0 0 0 0 0 0 0 0 0 0 0 0 0 0 0 0
0 0 0 0 0 0 0 0 0 0 0 0 0 0 0 0 0 0 0 0 0 0 0 0 0 0 0 0 0 0 0 0 0 0 0 0 0 0 0 0 0 0 0 0 0 0 0 0
