-10 -3 15 15 0 -10 0 -15 15 -2 15 1 -15 1 15 0 -2 4 -2 0 0 -2 2 -3 1 -1 -10 -3 15 -1 0 2 3 0 -2 0 0 0 -1 3 -2 0 -15 4 -2 3 -15 3 -3 15 0 1 0 3 2 0 -2 3 0 1 -3 0 2 0 -15 -2 2 -3 4 0 15 0 2 -3 0 0 15 2 4 0 1 2 -10 0 15 -3 1 -10 -10 -10 0 3 -1 3 0 -10 1 0 4 -15 
-2 0 -3 -1 -10 1 -1 -10 -15 -15 1 -10 -1 4 1 2 -10 -2 -15 -15 -15 1 -2 1 1 0 -2 -3 1 3 -3 -10 0 1 4 -15 4 15 0 2 -15 0 0 2 3 0 -2 -15 1 -2 -2 1 0 0 0 15 15 -2 3 4 0 2 -10 2 15 -10 15 -1 -15 -15 -10 -10 1 0 -10 0 4 -3 -2 -3 4 -1 -1 0 -10 -15 15 -3 2 -1 2 -10 -15 -1 -10 0 -1 0 4 4 
4 2 1 15 15 0 0 -2 4 3 4 0 -10 -3 15 15 2 -10 1 3 -1 4 0 4 0 -2 15 4 -10 -2 3 4 15 0 -10 -15 -3 -2 -1 4 -3 -15 2 -3 4 0 -15 1 3 0 -10 -10 2 -15 -3 4 0 3 -1 15 0 -10 0 2 -2 15 -15 4 2 15 -2 -2 -2 0 -15 4 0 3 1 15 0 15 4 3 -15 -10 2 15 15 2 -10 2 -2 -1 4 15 -1 1 -10 -15 
1 4 4 -2 1 -1 -3 1 0 -2 3 -3 1 0 2 15 1 -10 -2 -3 2 -3 2 -15 0 0 0 1 4 -3 -2 1 -10 4 -3 1 -15 2 -10 0 -3 1 -2 -2 1 0 -1 -2 2 2 0 4 0 -2 -2 0 15 -2 3 4 15 -3 -1 15 -2 0 1 2 3 -10 1 -1 3 -10 -15 0 -1 -10 -3 -10 -10 -10 -1 -2 0 -2 4 -1 0 -1 4 -1 2 0 -1 -2 2 15 1 -10 
-1 2 -15 15 4 1 -1 1 15 0 4 3 -10 0 -10 -2 3 -10 -3 0 -3 1 -3 1 15 2 0 -3 -1 -2 0 1 -3 2 -10 -3 3 0 4 -10 -15 -1 -3 15 15 1 -10 -15 3 0 -2 1 15 15 2 -1 0 2 0 -10 -10 0 -10 -1 1 -1 -15 2 -15 -15 2 15 -2 -15 15 -2 3 -2 -2 0 -3 -10 -3 -3 -3 1 -2 0 2 -15 4 0 -10 -10 0 -3 -10 4 1 0 
4 0 -1 3 -10 -10 3 -15 0 -15 15 -15 15 -10 -15 -10 2 4 15 -3 0 -1 0 -1 2 -3 4 15 -10 -2 -2 -1 1 3 -2 0 -10 -15 3 1 4 -10 2 -10 15 3 -1 -2 15 3 -2 -2 0 2 0 4 15 -15 1 1 -15 -2 -2 -10 2 -2 0 -1 -10 -15 1 -15 -1 15 -2 1 -2 3 15 1 0 4 4 -2 2 -10 0 0 -2 15 3 4 -2 -3 1 3 3 1 2 -10 
1 4 15 -1 4 3 0 0 3 2 4 0 15 -15 1 4 0 1 0 -3 0 -3 -3 -1 -3 4 -2 3 0 -2 2 3 -3 -3 0 4 -2 -10 -1 -2 4 -10 -2 4 2 0 -15 -3 3 -15 -15 -3 15 -10 -2 1 -1 0 -1 3 -10 -2 3 3 -15 -2 2 -2 -1 0 0 1 3 15 -1 0 15 1 -10 0 0 15 2 0 4 -3 1 4 0 -15 -10 15 1 -2 0 -1 3 -1 -15 15 
15 2 -1 0 -15 4 0 1 -15 4 1 15 0 0 15 1 15 15 2 -15 4 1 15 -1 15 -15 4 3 -15 1 4 0 4 -3 -1 4 1 -3 2 3 -3 -15 -10 -2 -10 -1 0 -1 1 2 -15 -2 -1 -15 -3 -2 -1 -1 -10 0 4 2 1 4 -3 -2 0 4 0 1 -15 -1 -2 3 4 -10 4 -2 -10 -10 -10 -1 0 -1 0 1 -1 4 1 1 -1 -15 15 -1 4 1 1 0 15 0 
-10 -1 3 2 -15 4 3 -3 -3 0 -3 -2 3 0 -3 4 1 0 -2 3 15 0 -10 0 -2 3 0 3 0 -15 -1 -2 1 4 -10 0 0 15 -1 3 4 -10 0 3 0 1 -10 2 4 2 -3 -10 -15 -15 1 2 4 -2 2 1 -1 2 1 2 -2 15 -15 3 -2 15 2 -10 3 -1 15 2 -3 0 4 15 1 0 0 -2 -10 -10 -15 0 0 15 -10 0 0 -3 -2 -2 15 -3 -2 1 
0 0 -15 -3 0 -2 -15 15 3 -15 -3 -2 -10 -1 -2 3 0 1 2 3 1 4 3 0 -10 -3 -10 -2 -15 4 0 3 -2 0 4 3 2 0 -10 2 -3 4 -10 2 -1 0 4 -1 0 0 4 15 -15 0 4 0 -3 -2 -2 0 -2 2 -2 -2 2 0 -15 0 -3 0 1 -10 -10 15 -15 -2 0 -10 3 -2 -2 4 4 -2 15 -2 -2 -3 -3 1 0 -10 2 1 0 3 -10 -2 0 -15 
4 -2 4 0 0 -2 -3 0 0 0 3 2 2 -1 0 0 -10 2 -3 -2 -2 -2 0 -2 -1 -1 2 1 0 0 0 0 15 2 0 4 4 4 4 -10 1 3 -2 0 4 4 2 2 0 -1 -15 0 -1 0 1 3 4 0 1 -15 0 3 2 15 1 -10 2 -15 2 -15 1 -15 2 2 1 0 -15 15 -1 -15 4 -2 -1 -2 2 0 15 15 -3 -10 -1 1 4 -1 4 -15 4 -10 -2 -2 
-15 -2 15 0 -15 0 -3 0 0 -3 -10 -3 15 4 15 -1 15 0 -15 0 1 3 4 -2 2 3 15 1 -3 -3 -1 -3 -10 0 -3 -10 15 -10 -2 -2 -15 1 0 -10 -3 2 0 15 -2 3 -15 -10 4 0 -15 2 0 15 -10 3 -1 3 -2 -10 1 -1 0 4 0 -3 -15 4 -2 -15 4 4 0 4 -10 -1 -1 15 3 1 -3 1 4 4 2 -2 15 -2 -2 -1 -1 3 0 -10 4 -10 
-15 -15 -3 -15 -3 0 4 -15 -10 -2 -15 0 -10 -15 -10 -3 -2 4 0 -10 0 -1 -3 -1 2 3 15 -3 15 0 -3 -15 -3 4 -3 -10 0 1 4 -3 15 15 2 0 0 2 0 -15 0 4 3 -3 0 2 1 3 -2 15 -15 15 2 -2 -1 2 -10 -15 -15 0 -10 -10 -1 2 -2 0 -10 -15 3 3 1 15 -15 15 4 -15 -15 -15 15 0 -10 -1 2 -2 4 -10 0 3 1 -15 15 -15 
2 2 0 0 -2 -10 -15 2 -15 2 1 -10 2 -3 0 -15 4 -3 1 0 4 -10 0 -2 0 -3 -2 15 -3 4 -10 -1 -1 -3 3 -1 2 -3 -3 -2 -3 -15 -1 1 2 3 2 3 0 2 -15 -10 -3 -1 -15 4 0 2 1 -3 3 -2 -2 0 -3 2 -1 0 1 0 0 15 -1 2 2 1 -10 1 2 3 2 -10 3 3 -15 -15 3 2 0 0 -10 0 -15 0 4 4 -3 0 0 -3 
4 0 0 -3 15 3 0 -15 2 0 3 0 4 3 -1 -2 -15 -15 -1 15 -2 4 -1 3 0 -10 0 -15 4 2 2 2 0 3 -3 3 3 -1 0 2 -10 -1 2 -3 0 2 -10 2 -10 -3 15 0 -2 0 15 0 -10 -15 -10 0 3 0 -15 4 -15 -1 2 15 0 1 2 -15 -2 -2 -2 15 -3 -10 4 0 -15 -10 -2 2 -10 -3 0 4 -10 15 15 -3 0 3 -3 -10 -2 0 3 0 
-2 -10 -10 -3 -1 -2 -2 -3 15 3 2 0 -10 3 0 0 1 1 0 15 -15 4 -10 -2 0 -2 -15 -10 -10 -3 -2 -3 0 -1 -3 -2 -1 -15 0 2 -3 -10 0 2 1 -2 0 3 2 0 -1 -3 3 15 0 3 1 3 0 -15 15 -10 3 1 4 -2 0 -2 3 4 3 15 -10 -1 4 3 -3 2 4 -2 1 2 0 1 0 -2 4 3 1 -2 -1 0 1 -3 3 2 -2 -1 0 4 
-1 -3 0 15 1 -3 15 -3 1 1 1 -1 -15 -15 -15 1 15 2 4 4 1 3 4 3 4 -10 15 -1 3 15 15 4 1 1 15 1 -15 1 0 3 15 0 -3 -1 -10 -1 4 1 -3 -3 0 -1 -10 -15 2 15 -3 1 0 3 -15 -1 15 -2 -3 -15 4 4 -10 -15 -1 15 15 1 -10 -3 2 3 2 0 -15 0 -3 15 -1 -3 -10 -3 0 0 1 0 2 -15 4 -1 4 4 3 4 
-1 -1 -2 0 1 -1 -15 0 -3 -1 2 0 0 -15 -10 1 15 2 15 -1 2 -10 4 3 15 15 -1 0 -2 1 -10 -1 0 -1 -3 2 -1 0 3 3 -1 0 0 0 3 0 0 -2 -2 -1 1 0 3 -3 -1 15 -1 -10 0 -10 -1 -15 -3 15 4 2 0 4 2 0 1 15 0 0 -3 3 3 -15 4 3 1 -2 15 -3 -15 0 -10 -1 1 0 3 -2 -1 1 -3 0 -3 15 2 3 
-1 -3 -2 -15 -10 0 4 -10 4 0 0 -3 1 -3 -15 15 3 15 2 3 3 1 4 -3 2 -15 3 0 15 -1 -15 -10 0 -3 0 0 0 1 15 15 15 1 0 -3 -2 -10 0 0 -10 0 -15 2 -15 2 -2 -15 -3 -10 15 -2 15 1 -15 0 -3 1 15 -10 -15 -15 4 -1 2 -1 0 -10 -1 -15 0 -1 -1 1 2 -1 0 -10 -10 -10 1 0 -1 -3 1 0 -3 -1 2 -3 -3 -2 
-15 -10 3 -15 -2 1 -10 -10 -15 2 15 0 -3 -10 -1 2 1 -1 4 -10 0 -10 0 -2 -1 -3 -3 2 -3 -1 3 15 -2 -15 4 -15 2 -1 -1 1 -15 -2 4 -10 1 0 -3 0 -15 1 0 -10 3 -15 15 4 4 0 1 1 0 1 2 1 0 -1 15 3 1 1 0 -15 0 15 2 15 -10 -10 1 0 -10 0 1 3 -3 -2 2 3 0 0 3 1 -2 1 15 1 0 4 -15 0 
0 4 0 2 4 0 0 4 -1 1 -2 -2 1 1 15 2 3 2 0 4 -2 -2 -2 2 -1 -15 15 0 -2 -2 -3 -15 0 4 2 0 -3 -3 -15 4 -3 1 -10 1 -10 -1 0 3 3 -3 4 1 3 -15 4 -3 -2 -2 -2 1 0 -1 15 -2 -10 4 4 -15 -1 -15 -1 -1 2 -2 3 -3 0 -15 1 -2 2 -1 3 -3 3 -3 -2 2 -1 -3 0 -2 15 2 1 0 15 -2 -15 -10 
0 15 -1 4 -2 0 15 3 -3 0 -2 -1 15 -15 -2 -3 -3 2 4 -15 2 4 -1 -15 -1 -1 0 4 -10 1 -1 0 1 -2 -2 3 0 -3 -2 -2 -10 -1 1 -2 1 0 -3 2 1 3 4 0 1 -15 0 15 1 -10 -10 -15 2 3 -15 15 3 15 -3 -2 1 -2 15 -15 4 0 4 0 0 4 4 -1 0 15 1 15 15 0 2 -10 1 -10 -15 1 -2 0 0 0 1 -2 1 0 
-15 -15 -15 -2 1 3 15 -10 1 4 -2 2 -3 4 -15 4 -15 4 -10 1 -3 -2 15 1 0 1 -10 15 -3 4 -3 15 -3 -1 0 3 0 -10 1 4 1 -3 -15 15 -15 -15 0 2 -2 2 -2 -1 -15 0 -2 4 2 3 -2 2 -15 -2 -15 2 1 1 -2 -1 4 -2 -15 -2 1 2 -1 -3 0 -15 1 -3 0 3 15 -1 2 2 -3 1 -10 -1 -1 -1 2 3 0 -15 0 1 -1 -10 
3 0 3 0 15 3 3 -15 3 15 0 2 15 0 -15 -3 4 15 4 0 3 15 -10 -2 -3 15 -2 0 0 0 -3 -3 -10 4 15 0 -1 3 -3 3 1 2 2 15 0 0 3 -10 2 3 4 -10 -3 3 2 0 -3 -3 0 -15 15 3 3 2 -10 -2 -15 -10 -10 0 -2 3 -2 -3 2 0 -10 -15 -10 -1 -15 15 -15 4 -15 0 -1 1 -3 -10 0 -2 0 0 4 -3 2 -3 0 1 
-3 2 0 3 3 2 -3 3 3 2 -3 1 -1 0 15 -10 -2 2 15 1 -10 1 0 -10 -2 -1 -15 -15 0 0 0 1 0 0 -15 -1 -15 -10 -15 -3 0 2 4 0 3 2 -10 0 4 1 1 15 4 2 -3 -3 4 -3 -1 -15 2 2 -10 1 15 2 -15 -1 -2 2 -3 -3 2 -2 -3 15 0 4 -10 -1 1 2 -15 -15 2 2 0 1 4 0 15 -10 0 0 -10 2 -2 15 -2 15 
4 15 3 3 2 -2 3 -10 0 -15 0 -3 -1 -15 -2 15 15 0 -15 0 0 15 2 1 3 15 0 0 0 -10 -2 1 0 1 -2 -3 -2 1 0 -2 -15 2 3 4 1 2 3 -10 -15 15 -15 0 15 3 2 1 4 4 0 1 -1 4 -10 3 0 0 1 1 -10 0 0 15 -15 1 0 -15 4 0 -15 15 -3 1 -1 0 -1 1 -3 0 15 2 4 15 -10 -10 0 -3 15 -15 3 -2 
-1 -10 -2 2 1 2 -3 -2 -2 2 1 1 -15 0 15 -1 2 0 1 1 -3 -3 -10 -2 0 15 -3 -1 -3 -1 -3 -10 1 3 0 -2 4 -15 1 3 -1 3 0 1 -2 -2 4 3 -10 -1 -3 4 -1 3 -1 3 1 0 -3 3 -10 4 15 15 -10 2 15 3 2 -3 0 15 0 -15 -15 3 -2 -2 1 15 -1 15 -1 2 2 15 -1 1 2 -3 -2 -15 1 0 -10 15 4 2 0 0 
15 3 -2 1 -1 2 -2 1 -1 -3 -15 3 3 15 -3 15 15 2 0 3 1 0 -10 3 4 -3 -10 4 -2 15 -3 0 0 1 0 -15 1 4 -3 0 -2 4 -10 0 -10 15 15 0 0 15 -15 1 -10 -3 4 -15 2 1 3 -3 0 -10 2 4 15 2 -2 0 3 -15 -1 0 0 0 -1 0 -3 4 -3 4 -10 -2 2 -15 -15 4 1 2 15 0 4 0 -10 -1 -2 -2 -3 1 0 -10 
15 1 0 -2 -10 -2 -3 -1 -15 0 0 1 4 0 1 -3 0 2 0 0 -3 -2 -1 0 0 -2 0 4 0 2 0 -15 -15 15 -10 -15 0 -3 0 2 0 -2 0 3 -10 -15 4 -2 -1 -10 -15 -1 2 1 0 -3 4 -3 -10 -1 -10 -3 4 -3 1 4 -10 3 4 0 -1 -1 -1 -2 4 4 15 -10 1 1 -10 -15 2 15 3 -3 -3 -10 -2 0 2 0 -15 3 2 0 0 -10 -1 -10 
-10 -1 -15 0 -2 1 4 -1 -3 -1 -1 -1 -10 0 -3 -3 1 -1 -15 -2 -3 -15 -1 15 3 1 -15 0 15 -3 2 -2 1 -10 -1 3 0 -10 -2 -3 -15 -1 -1 2 2 0 -2 -10 -2 -2 -10 15 -1 0 -1 1 1 0 2 -3 2 -15 3 15 15 3 -1 1 -10 15 -15 -15 1 15 -3 -15 -1 1 -3 -1 2 0 4 15 2 0 3 -1 -10 4 1 -1 1 2 1 -2 -1 0 -3 4 
-10 0 -3 0 -1 -1 -3 0 3 -3 0 0 4 0 -1 3 15 0 -1 -15 -10 1 -2 -10 -2 15 2 4 0 -15 15 -3 -2 4 0 3 4 3 -3 0 15 15 4 4 3 0 -3 3 -10 4 -1 2 0 0 0 3 -15 2 -1 -1 2 -1 -10 0 -15 0 3 -3 1 0 -15 1 4 4 -1 -10 1 15 15 -10 0 -2 3 -2 0 1 -1 -10 0 -2 -1 2 1 2 0 1 15 -3 1 -15 
-10 -10 1 -1 0 15 15 -15 2 -10 -3 4 1 -15 2 -2 1 -10 0 4 -1 0 1 0 3 2 1 -3 0 15 -10 4 2 0 1 -2 2 4 4 4 -1 1 15 15 0 1 -3 2 0 15 -2 2 1 15 1 -1 2 -2 -3 -15 -2 3 -1 0 -2 -2 3 0 0 -2 -15 0 4 15 1 4 15 0 2 -1 -10 -2 0 -15 0 -10 3 0 4 -1 3 1 -10 2 -2 3 -1 -3 2 0 
0 3 0 -1 -2 4 3 4 0 -2 -10 0 3 -3 15 1 -3 0 15 -15 1 3 4 3 -10 0 3 0 -3 3 0 -10 -3 -15 4 -15 0 -1 -1 1 -10 -1 0 1 0 0 15 -15 1 2 -10 -3 -1 -1 2 15 -2 0 2 3 -3 2 -1 0 3 0 -15 0 0 -2 -1 3 -1 0 1 4 4 -2 -2 -3 -1 15 2 0 -3 1 -1 15 -10 3 -2 2 0 15 3 2 -3 -10 2 -10 
1 -2 -2 1 4 2 15 -10 -2 2 1 0 3 3 -10 1 -2 -10 -1 2 -3 0 4 -15 -2 3 -10 3 1 -1 2 4 -3 2 -2 -3 3 4 -15 2 0 4 -10 2 2 2 -15 -15 2 1 -2 0 -2 1 3 -15 3 3 2 -1 -15 -15 -10 15 -15 -10 2 0 -1 1 -1 1 2 1 15 -10 4 -3 -1 -1 4 4 -3 4 -3 15 -15 15 -2 0 -15 -2 2 4 1 3 15 0 -15 0 
3 -2 -10 -1 15 -15 -3 -2 -15 -10 -15 -2 4 -2 15 2 2 0 0 4 -3 4 -3 0 0 -3 0 3 1 -15 -1 2 0 15 -15 1 3 -10 3 3 2 -1 -3 3 0 0 2 3 0 -2 0 0 0 -10 0 -15 -10 1 2 -2 -10 15 2 3 15 2 -2 15 -3 -10 4 3 15 1 -2 0 -15 4 -2 4 0 0 3 0 -15 3 1 15 0 0 0 -3 4 -10 -3 3 1 15 0 4 
1 2 3 2 0 2 3 -1 -3 0 -1 -10 0 -2 -10 4 0 -1 1 2 1 3 -10 0 -10 15 -15 4 -2 0 15 4 15 -2 1 -1 3 -15 -1 -3 0 3 -1 -15 -3 3 3 3 -10 -10 -2 3 -2 0 4 -1 2 3 -2 4 0 1 15 0 -10 -1 -3 3 -15 -2 0 -2 15 -15 1 2 -15 2 -15 -10 0 1 -3 0 -2 3 0 0 3 3 -3 2 -2 2 1 2 0 -3 -2 -10 
-2 3 -3 1 4 -2 0 0 -1 -15 1 -10 -3 15 2 2 0 1 0 -10 -2 2 1 -1 -3 -15 3 1 1 2 0 3 1 4 1 2 -1 3 -2 0 -1 -10 4 -3 1 15 0 -3 0 0 -10 -3 2 2 1 3 -2 -15 15 1 2 1 0 3 0 -3 4 -1 15 1 -15 0 1 1 -2 -15 -2 -10 -10 -15 -1 -2 4 1 2 0 -2 1 -3 -15 -3 2 2 3 0 15 3 -1 -15 -1 
-1 15 -3 -3 1 3 0 -2 4 -10 3 -3 2 -15 3 15 1 0 0 2 -15 0 4 -15 15 4 4 15 -1 3 4 -3 -15 0 4 -15 4 -2 1 0 -10 0 -3 -10 0 -2 -3 15 2 -10 -2 -1 0 1 0 -1 0 15 15 2 1 1 -3 4 -1 -1 4 3 15 0 -1 3 0 0 -2 2 4 -1 1 0 2 2 -15 15 -10 -1 -1 -15 -10 0 3 0 3 4 -10 -3 -2 3 -1 0 
-15 3 0 15 -15 -1 0 4 1 -2 -1 4 2 3 4 -2 0 1 2 3 4 0 -2 -3 0 -2 4 2 2 -1 -3 0 -1 0 4 -2 0 2 -1 15 15 0 2 -3 -3 -10 -2 4 -3 1 2 2 1 -2 -1 2 -10 -2 -15 -15 3 2 1 2 2 -1 0 1 15 0 -2 3 2 0 0 15 3 -2 -1 -2 -3 -1 -15 0 -10 -1 15 1 -15 -3 -10 -1 -15 -1 -3 -3 0 3 -2 -10 
-3 -15 -15 4 -1 0 -15 -15 15 -15 2 2 -1 0 1 -1 15 0 15 0 -3 -10 -2 4 -1 1 0 1 1 2 0 0 1 0 -3 -2 -15 -3 -3 -3 -2 3 0 -2 0 0 3 0 1 -2 -2 2 -1 -10 0 -2 -15 -3 0 0 -15 2 -2 3 3 0 0 -3 -10 15 -3 -10 -15 -15 4 3 -1 4 -3 -3 -10 1 0 -10 0 15 2 15 -1 4 4 -15 1 -3 -2 -1 -10 0 15 3 
-3 -15 -2 -10 15 2 15 3 -3 2 0 2 4 2 -2 15 -15 -3 1 -1 -10 -2 0 -15 -1 -2 0 -2 15 -3 0 3 -3 1 -3 -10 -1 -3 4 1 2 4 0 0 -15 2 0 15 0 0 0 3 15 0 2 2 -15 3 15 -10 -15 4 1 -3 -10 1 1 -10 -10 3 0 -2 0 4 0 -1 15 -3 1 3 2 -10 3 3 4 1 -1 4 -2 -2 3 0 0 15 3 4 0 -2 0 -10 
3 15 -15 0 4 -10 3 -1 15 0 0 1 3 3 0 4 -3 0 -1 1 -3 -2 0 0 2 1 -2 -1 -10 -15 2 -2 0 0 1 2 -10 0 -15 2 3 1 1 4 4 2 -15 4 -1 1 -15 -2 -10 3 0 -10 2 -15 4 3 2 -15 -10 0 -10 4 -10 -1 -15 -10 -10 -1 15 4 -3 3 15 2 4 15 2 0 2 15 -10 4 -1 -1 -1 4 -1 3 0 -1 3 4 -1 -10 -1 4 
-3 -10 0 1 0 0 3 0 -3 2 -15 4 3 4 -15 -1 -2 -10 4 0 1 -10 -1 2 1 -2 4 -2 0 0 -2 0 -3 0 2 1 15 -2 4 15 -1 -2 0 -1 3 0 3 -10 -15 3 4 0 0 -3 15 0 3 0 15 -10 15 0 15 0 0 3 -3 -15 -10 3 3 15 -1 15 4 0 -10 0 -1 0 15 1 0 2 15 3 0 -2 15 2 3 0 1 0 -10 4 -1 3 -1 1 
1 1 -3 3 15 3 4 2 4 -3 -15 -15 1 0 -10 -2 1 2 -1 4 15 15 1 4 0 -2 4 -2 -15 -2 15 -10 -3 15 1 0 -2 15 15 -3 2 1 0 0 0 1 -3 2 0 -10 -3 3 -15 1 1 -2 -10 15 1 0 -2 -2 2 0 -3 2 0 -1 0 -1 -3 0 2 3 -1 15 -2 3 -15 -2 3 -15 0 2 -10 -2 15 -10 2 0 -3 0 4 -15 15 0 -3 0 -1 4 
1 0 -10 2 4 -2 -2 4 3 3 0 -15 15 -1 -2 1 -1 1 2 -3 2 1 -10 -2 -15 0 2 2 2 15 0 -3 3 4 0 1 4 0 1 2 -2 3 15 1 0 2 3 -1 -15 4 15 0 -15 3 -15 4 3 -10 2 -15 -3 -15 0 4 3 -15 2 4 -3 0 -10 3 1 -3 0 1 2 15 -1 -10 2 -10 15 -15 -2 1 0 -2 -3 -10 2 0 -1 2 2 0 -1 3 1 -2 
-3 -2 -3 -10 -2 4 4 0 4 2 -2 -10 -10 -2 -3 0 2 -3 4 2 4 4 -3 -15 2 -1 1 3 0 -3 -2 3 -2 -10 -15 15 1 3 -2 -2 -10 -2 0 -10 15 15 2 0 0 0 -3 0 -15 15 2 -10 -1 1 -3 0 -10 15 0 -15 -10 15 4 3 4 0 -3 -10 1 -10 -10 0 15 0 4 -3 -2 0 -3 4 0 3 15 1 -10 -2 15 0 0 -10 3 0 -2 -2 0 2 
1 3 0 2 -1 2 -15 1 -3 1 -3 1 -10 -3 1 2 4 15 -1 1 1 2 0 -10 4 -3 -1 4 -3 -10 -3 1 -3 -15 15 -15 0 4 2 0 2 4 -1 2 4 0 15 -3 -3 1 2 -1 2 15 0 2 0 -2 -1 -3 -1 1 1 3 -2 -1 4 -1 3 1 0 -3 -15 0 2 1 0 -1 -1 3 -3 0 -3 0 2 4 4 0 -10 -3 -2 -1 15 2 -10 1 1 -15 -1 2 
3 15 -15 3 -3 2 -15 4 -15 2 -15 -2 -2 1 -2 0 1 15 -1 -3 -10 0 3 -3 0 -10 15 1 0 -3 -2 -15 -3 2 2 -15 4 15 4 15 3 4 4 -1 3 -15 4 2 -2 0 -2 1 -3 1 3 -15 2 -15 -15 -1 -15 15 -2 15 -3 -2 15 3 -10 -3 0 3 -3 -3 0 3 3 -10 -3 1 4 -15 -10 0 -15 15 -2 2 -3 -3 -2 1 -1 15 4 -10 -15 0 1 3 
3 -1 0 1 3 0 -15 -2 -15 2 3 15 15 0 -1 -2 -2 -1 3 0 0 -2 3 -15 4 -3 -15 0 -15 0 15 3 2 0 0 -1 0 -1 4 0 -1 -15 -15 4 -2 0 -3 -2 -2 3 1 0 4 -15 2 4 -3 15 4 -3 2 -15 -3 -3 -3 0 1 -2 -15 -3 0 0 -10 -1 4 0 0 -10 2 3 -3 15 0 -1 0 -2 -1 4 1 -2 -10 2 -3 -10 3 -2 -1 -15 3 0 
-15 3 -3 -10 2 15 2 0 3 0 4 3 1 0 -2 -2 4 3 0 0 4 -3 0 0 1 15 -15 -15 2 0 1 3 3 0 -3 -10 15 2 1 -10 0 0 4 15 -15 4 -2 -1 4 1 0 0 -10 -10 1 -15 4 -2 -10 4 -15 -2 15 0 4 -15 -10 4 0 -2 3 15 -1 15 -3 -15 0 15 0 -10 4 -1 -1 -15 15 -10 -3 3 15 0 1 1 -10 4 0 -15 -10 0 2 2 
4 0 -3 4 -3 -2 3 -10 3 0 -2 15 0 -1 15 4 4 -2 1 1 0 0 3 -2 -2 -10 -1 -10 2 -2 2 0 15 0 15 -3 -10 -1 0 -15 0 0 0 -2 0 -10 -3 0 -3 2 -10 3 -15 -3 -10 4 -1 -2 -15 15 3 0 0 -3 1 -15 3 -2 -2 -2 -15 0 -1 0 -15 -1 3 -3 2 -1 -1 -2 15 -2 -10 -10 15 1 4 -15 -15 2 2 -3 1 -2 2 0 3 4 
0 -2 4 2 -15 0 -1 3 0 -15 -10 3 4 0 0 0 -1 1 -2 0 -3 -15 4 -1 -3 1 4 15 -15 4 0 0 4 15 2 4 2 1 -10 15 -15 1 4 -1 0 -15 -3 3 -3 -15 -15 -2 -10 3 -10 -10 -10 1 -3 15 15 -10 -15 4 -2 3 -10 -15 -15 -15 3 0 15 -1 1 2 2 1 -10 -2 4 15 0 -2 -2 0 -10 15 -10 3 -2 3 -10 -3 -2 -10 1 -2 3 1 
-1 -1 -15 1 -1 -15 -10 2 0 15 0 0 -10 -3 4 3 -10 2 0 0 -3 0 0 0 -2 3 4 4 3 -2 1 -1 3 1 0 -15 0 4 -10 0 -2 -2 -2 -3 -2 4 0 -3 -2 2 2 4 1 -1 2 3 -10 0 -2 -2 15 1 0 -2 15 -1 -10 0 2 -10 4 0 3 3 0 0 2 0 -15 2 15 0 -3 4 2 -1 -2 -1 2 4 -15 15 1 0 3 3 4 2 3 3 
2 -2 -3 -1 2 1 -15 -3 -15 -3 0 -3 -2 -3 3 3 4 2 -10 1 -15 15 -3 -3 -3 -2 -10 -1 -10 2 -2 -2 -15 -1 -3 -15 0 3 2 -10 1 3 -3 -2 3 -3 15 4 -2 2 1 -10 15 4 3 1 15 -15 3 -15 1 0 15 4 15 0 -2 2 2 -3 0 3 -10 -2 -2 -15 1 0 -10 -15 -3 -1 -2 -2 1 -2 0 0 2 4 15 -1 -10 -2 -1 1 -10 0 -1 -3 
-10 0 1 3 1 -10 -15 15 -15 -2 3 -1 3 -1 0 2 -10 1 -15 -15 0 4 15 -2 -3 -1 -1 -1 -1 -15 -10 -1 2 2 -10 2 -2 -10 15 15 -2 1 4 -15 -15 -2 -2 -2 -3 -3 -2 0 -15 -3 -2 1 -10 2 1 15 -15 15 -10 -3 0 1 4 -2 4 -10 -1 1 2 -10 4 0 1 2 0 -1 0 -10 3 -15 15 -2 0 15 -2 0 -2 -10 3 -3 -3 15 -3 0 0 -3 
-10 -15 -2 0 1 -2 3 -1 0 4 -3 15 -3 0 1 3 1 2 -10 -15 3 -3 -15 15 -15 -15 4 -10 -15 -3 -10 3 -15 -2 -10 4 -15 4 4 -2 -10 -15 -10 -1 0 0 -10 15 2 1 0 15 0 -2 3 -10 0 -2 -1 -2 -2 -15 3 0 -15 0 -10 -2 -1 -15 3 -10 1 4 -2 -2 -10 0 0 -3 -10 -3 1 4 -10 3 3 -1 -10 0 -1 0 0 -10 -1 -1 15 -15 15 -3 
-10 4 -1 0 15 2 -10 15 0 2 0 1 -2 4 15 4 -2 -2 -1 15 -2 -2 -2 0 15 4 -1 -2 2 1 -2 -10 0 0 3 4 0 15 -1 -3 -2 2 1 4 -3 0 -2 2 0 -1 -3 -1 15 15 0 -2 0 -15 0 3 -1 15 4 0 2 0 -15 -3 -10 15 -15 0 0 -15 -10 15 0 -2 2 -15 0 -3 0 3 -3 -3 -2 4 15 4 3 0 15 -3 -1 -10 -15 2 0 1 
1 2 -15 2 4 2 2 3 -15 0 -3 0 -10 15 4 1 1 -2 2 0 15 1 4 4 0 -15 0 4 0 4 0 1 -1 4 0 -1 -2 15 0 -2 -10 -1 0 15 1 2 15 0 1 2 -10 -1 4 0 0 0 -1 15 3 -15 -2 -2 0 3 -3 1 -1 -2 0 0 -10 -10 15 -1 15 -3 4 15 -10 2 0 -3 0 -15 1 -10 -10 15 1 -15 0 15 0 4 1 0 -10 -10 4 3 
0 2 0 0 3 -3 -2 15 0 2 0 0 -10 3 -3 3 1 -15 -10 0 -2 1 -3 -3 -15 15 -3 3 1 -1 15 15 -15 -3 -2 -15 1 -15 -1 -10 1 1 0 1 1 3 15 -1 3 1 0 4 4 -2 -1 0 0 2 15 1 1 -10 15 2 -3 2 -10 0 0 -2 -10 0 4 3 -2 4 3 -2 -10 0 -3 0 -2 -2 -15 1 2 -15 3 3 -3 4 -1 2 -1 0 0 -3 0 0 
0 4 -2 2 -2 -2 1 2 -3 -10 2 1 -1 -3 -3 -10 15 15 3 0 1 -10 15 0 1 -2 3 0 0 0 -2 -10 1 -2 -10 4 -2 -1 4 -3 0 2 -2 15 2 -2 3 -10 0 0 -3 -15 3 -3 4 -1 -10 0 4 0 -2 4 -3 0 0 -15 -2 4 0 0 15 2 2 15 -2 3 -10 -2 -10 -10 2 -2 3 -10 3 2 3 -3 2 -2 0 1 2 -10 -3 -10 -2 -2 -15 -10 
15 4 -10 1 0 -2 0 -1 -3 -15 0 15 -3 3 0 15 -15 -15 0 4 -1 -15 2 2 0 -10 15 1 -3 2 -2 -1 0 3 4 1 -10 0 2 -2 -10 3 -1 -1 -15 -2 -3 1 2 0 0 15 1 1 -1 2 -10 1 0 3 4 0 0 -1 -10 -15 4 0 3 -15 0 3 -2 1 3 0 -15 -15 1 3 3 -2 -1 4 3 3 15 -2 -15 15 0 0 1 -3 -15 4 3 3 -1 0 
3 -1 4 -3 -10 -10 -2 1 1 0 2 4 -1 -15 0 4 -1 -2 -15 -3 4 0 -1 -15 4 -10 -10 4 -2 0 0 -3 0 -15 -1 3 -2 3 1 -10 -15 -1 -1 2 -2 -10 -3 -1 -3 4 -3 -2 2 3 -1 -1 -10 -3 -3 4 4 -3 -3 0 0 1 -10 0 0 -10 2 -3 0 0 0 -1 -3 -15 -1 -1 15 4 4 -10 2 0 0 0 -15 -1 -15 0 15 -2 3 1 -2 0 -15 3 
-10 3 0 15 4 0 15 0 3 -15 3 0 -1 4 3 3 -2 -3 0 4 3 15 -1 -2 -3 -2 3 -10 0 1 3 0 2 2 1 -3 -3 0 2 2 -10 0 1 -1 -10 15 0 -1 -1 0 -1 15 15 1 -15 -3 -3 3 4 1 3 0 0 -15 4 -3 2 1 2 4 2 0 15 2 -15 0 -1 2 0 2 15 15 -2 1 -2 1 -3 -10 -2 -2 4 4 0 0 -3 -15 15 -10 -3 2 
-2 1 -15 3 -1 -1 4 -3 -15 -1 4 -10 15 -3 -1 0 2 -10 4 -1 15 3 -3 1 -10 4 1 -15 15 -2 0 3 4 -1 3 -3 0 -1 1 2 15 -3 -10 -15 4 0 -2 -15 2 -2 -10 0 -1 0 4 3 -2 -1 -1 -15 3 -10 -3 -15 -1 1 3 2 3 -15 -3 -1 -2 -15 -10 1 2 -2 -10 -3 4 0 2 1 -1 1 15 -1 3 1 2 -2 0 -3 -2 1 4 -3 1 15 
-2 2 -15 1 15 0 2 -3 -3 0 1 -2 0 -10 -2 -1 3 0 2 0 -10 -15 2 0 0 4 0 -3 3 -15 -1 -15 -3 -10 1 -2 0 15 0 -3 15 -10 4 -15 -1 15 -1 3 15 -1 3 -3 0 -3 4 15 0 2 2 -1 3 15 -3 -3 1 4 -2 15 -1 -15 15 0 -2 0 2 0 -15 -3 1 0 -3 -15 -2 -10 0 3 -3 0 -2 1 -2 1 -15 -10 1 -3 0 -2 15 -1 
1 -1 2 15 -2 3 3 0 0 15 15 2 2 4 15 1 0 2 2 0 -3 0 3 1 -3 -15 0 -10 -1 -1 15 0 4 -3 4 15 4 0 0 4 0 15 2 15 -2 -10 1 4 1 15 2 -1 15 0 0 -10 -15 0 -2 -3 1 0 1 -1 0 2 0 -15 3 3 -15 -10 -1 -2 -1 0 -10 -15 -1 -15 0 4 4 3 0 0 -3 1 3 4 -1 15 1 -10 1 4 3 2 -1 -15 
-15 2 1 0 2 -3 -10 -2 2 -3 0 4 -1 -15 3 15 -15 0 -15 -3 -15 -10 15 -15 15 -3 -15 3 0 -15 -10 2 -3 15 0 0 1 15 -1 0 -2 -1 3 3 -1 -15 1 -1 0 15 -15 0 4 -3 -15 -10 0 -2 1 15 2 0 -10 1 -2 3 -10 0 1 0 -3 -2 -2 2 3 0 1 -3 -10 1 -2 4 0 -3 -15 1 -10 15 1 2 3 -2 -1 4 1 0 -10 -3 15 -3 
-10 -2 4 3 -3 -3 -15 15 -1 -3 -2 3 -3 -15 0 1 15 -1 -15 2 -1 -10 -1 0 -15 -10 -3 15 15 -3 -1 1 -10 -3 0 -3 2 4 2 -15 -15 4 -3 0 0 -2 2 -10 4 1 -10 15 -15 -2 3 3 3 -15 1 -2 2 -3 3 0 2 -2 15 4 -2 1 -3 0 15 -3 -2 -15 2 2 0 15 4 15 -3 1 -15 3 1 -1 1 -10 2 -3 4 15 15 -3 1 2 15 -15 
4 -15 0 0 0 -10 0 1 15 0 1 1 -1 15 -3 -1 15 0 15 -1 15 1 -15 -2 15 -1 3 -10 3 3 -3 2 -3 2 15 0 -1 1 1 1 0 1 -15 4 -3 -1 15 0 -3 2 -15 -2 4 -10 0 15 -2 3 3 -15 -10 -2 4 -2 -15 3 0 -15 4 1 1 -10 -15 1 0 -10 -1 15 3 2 3 -3 4 0 3 2 0 -3 -10 -15 3 -10 2 -2 4 4 -1 -2 0 -10 
0 -15 3 -15 -10 2 1 4 -10 3 4 -10 -15 -1 -15 -1 -2 -15 0 2 1 -10 1 -10 -2 4 -10 -2 2 -10 0 0 15 -2 15 0 1 -10 0 -1 1 -3 -10 15 1 0 -2 -15 2 4 0 0 0 0 3 -1 -2 -10 -15 1 15 -2 15 -2 -10 15 3 1 4 4 -1 -15 -10 -1 -15 0 -1 0 0 15 -2 -3 1 1 -10 2 -2 -10 0 3 0 -1 0 -15 2 -10 -10 2 1 0 
3 -3 1 -15 4 -1 -2 -3 0 -3 -15 1 2 -15 -3 -10 -2 -3 -10 -3 -1 15 0 4 -1 -1 -2 -15 -15 2 1 2 4 1 3 4 0 -15 -1 -15 15 1 -1 -3 2 -10 0 2 -1 3 -10 0 2 -1 2 -15 -10 0 0 4 -3 4 4 -2 0 -10 1 3 0 -3 1 -3 -3 -15 -15 4 -3 0 4 4 2 2 -3 2 -1 0 0 2 2 2 -2 -3 2 -3 0 1 4 4 -3 -1 
-15 1 -3 -15 -2 3 4 3 -1 -10 0 0 -15 3 2 0 1 15 -3 0 0 -2 0 1 3 0 3 0 -1 1 -2 15 2 2 -10 1 -15 4 -10 2 -3 15 15 2 -1 -15 -15 0 -10 15 1 15 -15 -3 -15 -15 1 4 15 1 0 -15 2 -3 1 -10 -2 3 3 2 15 -3 -1 -10 -2 1 15 3 -3 -15 1 0 3 0 -10 2 0 15 -3 -15 3 -10 -2 15 -10 -10 3 1 -15 -10 
-1 -1 -3 0 -2 -10 0 1 15 -2 15 -2 3 -3 0 15 0 2 3 -2 3 -10 4 0 4 15 -10 1 0 3 -1 15 3 -2 -10 1 -2 0 -2 0 0 15 4 -3 1 2 -3 15 -2 1 -1 2 -3 2 3 3 4 0 -3 15 0 2 15 -2 3 15 -15 2 15 0 -15 -1 -2 15 1 -15 3 -1 0 0 0 4 3 4 15 0 0 0 -3 -3 -3 -2 15 2 -15 4 4 -3 2 -10 
1 -3 1 1 0 2 1 1 15 15 -15 -1 2 2 4 15 3 -15 0 4 -2 -15 2 0 -15 4 4 0 3 -3 -10 -3 3 1 -3 2 -15 15 -3 2 0 1 4 0 1 0 -3 -2 0 0 1 3 1 1 3 -10 -15 0 4 15 2 -2 -10 -1 0 0 -10 -15 0 0 15 1 15 1 2 2 4 -3 -15 0 4 3 -15 -2 -2 -10 3 -2 -15 15 2 -3 -3 -2 3 2 -15 2 -2 0 
0 -15 4 -3 4 2 -3 -3 -3 -15 1 -1 15 0 0 4 15 0 0 0 0 -15 0 2 2 3 -1 -2 1 -10 15 -1 0 3 -1 3 -2 0 4 4 -10 -1 2 1 1 1 15 1 -2 0 3 0 -15 3 -2 -3 0 15 -2 4 -15 15 15 0 15 15 0 -10 1 3 -2 0 4 -1 15 -15 -1 4 15 -15 -2 -10 -3 2 3 -10 15 4 -2 -1 -1 3 -2 2 15 -10 -3 -3 -10 3 
-3 4 -15 1 -3 -3 15 -15 1 -2 1 0 -2 -10 -2 3 15 -10 0 -10 -3 2 2 15 1 0 -1 2 15 4 -10 4 -3 0 1 -1 3 3 0 3 0 15 15 -1 -1 4 -2 -2 4 -3 -15 0 0 2 -10 -10 15 -10 0 1 2 4 4 4 2 2 -10 -3 -10 4 0 4 -10 0 2 -10 4 -3 -1 -15 4 -3 3 -10 -2 2 -1 0 -3 -15 -10 3 -2 1 4 -1 4 -3 2 0 
15 -3 -2 -3 4 -3 -1 -15 3 -1 1 -2 4 -1 2 -2 4 -15 -2 15 2 1 15 -10 -1 15 -15 -3 2 -1 0 2 4 0 15 -15 0 1 -10 15 -10 -15 4 2 -15 0 -10 0 3 0 -3 0 -10 0 15 4 -1 0 -10 -15 -10 -15 -1 2 0 0 3 1 -3 0 3 3 -3 -2 0 -2 -1 1 -10 1 3 4 0 -2 -1 4 15 4 0 3 15 -3 -1 -15 -10 -3 1 -1 0 -10 
-2 -3 3 -15 2 0 -2 -3 4 0 4 -3 1 -10 4 0 0 0 3 0 -2 -2 3 -10 -3 -3 0 2 0 2 3 1 -15 15 -2 -1 -1 -15 -3 -3 4 -1 -1 0 -2 1 -10 -15 0 -1 -3 2 4 4 4 -2 -1 2 3 2 2 3 0 0 15 -3 -3 0 3 1 0 -10 4 0 2 4 -15 0 -2 3 -15 0 -10 -10 4 0 2 4 3 1 -3 -2 0 2 1 0 15 -10 15 4 
15 2 0 -10 2 3 15 -1 -15 1 0 -10 0 -2 3 4 -1 2 -15 -3 -15 2 15 2 0 0 4 15 -10 -1 -1 -15 1 -2 0 1 -10 0 15 -2 0 -10 1 -2 -3 2 2 15 -1 0 15 -15 2 -1 15 -10 -2 4 -15 -3 2 0 -15 -3 1 -2 -3 3 0 -15 2 0 -10 0 -10 4 -2 -10 1 -2 2 1 3 15 -1 -10 1 4 2 0 0 -10 -3 0 -2 0 1 1 -15 -2 
-10 3 -1 2 -15 0 0 1 -3 4 -3 15 -2 3 -1 -10 -10 -1 3 0 15 15 0 -3 1 2 -1 0 4 -3 -3 0 -10 2 3 1 -3 -2 4 0 15 3 3 -2 0 4 -2 1 15 -1 2 2 0 1 0 -10 -2 -10 -15 0 0 -3 4 -3 -3 -2 -1 15 15 -2 -3 4 -1 0 -3 0 -3 -2 1 1 -1 -3 -10 -15 15 -3 2 3 -3 -3 0 15 -15 -15 -10 -2 -2 4 -3 15 
-10 -10 -15 0 1 2 -1 4 3 1 -15 -2 -10 -3 1 2 3 -3 -10 1 1 -2 0 3 -15 1 4 -1 2 -1 -3 0 -1 3 4 3 15 -2 -15 15 15 4 3 -10 0 0 -1 0 4 -1 -15 -10 2 0 2 15 -3 15 15 -1 -1 2 1 0 -2 -10 2 0 2 -2 1 0 -2 2 -10 0 -10 3 4 -3 0 0 -1 -3 -3 -15 -15 0 2 -15 -1 -10 2 0 -10 -2 -3 -1 3 0 
-10 -1 0 -15 0 -10 -2 -15 1 2 -15 3 -1 -2 -15 15 -1 4 -3 -2 1 15 0 -10 3 15 -2 -2 4 15 -1 3 2 15 3 4 3 -15 -15 -2 2 2 1 3 15 2 -10 0 -10 0 3 -2 4 -1 0 -3 -2 3 -10 -2 0 4 0 2 0 -1 -3 -15 3 -2 -1 1 -2 0 -2 2 -3 4 1 0 0 0 2 -10 -1 3 15 0 2 1 -3 15 3 2 15 2 3 -1 -2 4 
-15 0 1 2 -1 0 -3 -1 4 -15 3 0 -2 -10 1 1 3 0 0 -15 0 0 3 2 0 -1 0 1 1 3 -10 1 2 -1 115 -3 3 2 2 1 -10 -10 115 -10 -1 -10 -2 -115 -1 4 1 -1 115 1 -2 -2 -2 0 115 -3 4 -2 1 1 2 -1 4 -115 4 -115 0 3 0 -1 -115 0 0 0 0 -2 0 1 4 0 115 -10 -3 1 3 -10 3 -2 0 -3 115 4 4 -10 3 0 
1 1 0 4 115 0 -2 -3 -1 -2 2 115 0 3 -3 0 2 -115 -115 -115 -1 -10 -2 1 0 115 1 115 -3 3 0 -2 1 -1 -3 -115 -10 -10 0 4 1 4 4 -115 0 -10 2 -115 2 -115 4 4 2 0 0 3 115 -3 -2 2 4 3 115 -10 0 115 -2 -2 -3 -10 -3 -115 4 0 2 -115 2 1 4 -3 -3 4 -1 -3 -3 0 0 -115 -10 1 -10 -3 1 -115 -1 3 115 0 -115 3 
0 2 -115 0 2 -1 2 0 0 -3 2 0 2 3 4 -115 -115 0 115 4 -1 -1 -1 4 -2 -115 0 3 -1 -1 1 1 0 -2 1 2 2 -1 -2 2 -1 -10 -1 115 -10 -1 115 -10 2 -115 1 -2 -2 115 -1 -115 -3 0 2 -10 115 -115 115 -2 3 115 -3 0 0 2 0 0 -1 0 3 -115 -3 3 -1 -1 -115 3 -3 -115 4 0 115 -1 4 0 1 -2 4 115 -10 3 2 2 0 -115 
-2 3 3 2 2 0 115 -10 -115 -1 -115 -3 -115 -2 115 0 2 4 4 0 -10 0 -2 -1 -10 -2 -10 -2 -2 4 2 115 1 115 -1 4 115 4 3 4 -2 0 -115 0 2 -115 3 -1 0 0 0 2 -3 115 0 3 0 115 3 -2 115 0 3 1 4 -10 2 -10 -3 -2 -3 3 4 115 -1 115 0 3 1 3 -2 -3 0 -115 -10 -3 0 0 1 0 -2 -115 0 -115 1 -1 3 1 -2 -10 
-2 -1 4 2 115 4 -1 -1 2 -115 -3 4 3 115 -2 0 0 115 -3 -3 3 0 -2 -2 4 -115 115 -3 -2 -10 -3 -1 1 1 -115 -115 0 -115 0 -2 -3 -2 -2 -115 1 4 1 0 -115 -3 -1 -115 -3 4 0 -2 115 -2 115 -115 1 2 -3 2 0 -3 -115 1 -1 3 -1 -1 -2 1 -115 0 1 -3 -115 -115 3 1 -3 -10 4 0 -10 4 2 0 -10 -3 115 -115 -2 115 115 1 -2 -10 
0 0 4 2 4 -10 2 -1 -2 3 -10 3 0 -3 1 3 0 4 -115 -3 -2 4 1 0 -1 -1 0 2 115 0 2 -3 -3 115 -3 -2 -2 3 4 -10 0 -115 4 4 -10 0 115 -3 0 -2 115 1 3 2 -2 3 -3 3 -10 -3 -115 3 4 0 -10 3 4 -115 0 0 4 115 -2 4 -2 -3 -2 -115 2 -10 3 -10 -3 2 0 -2 -2 -3 1 -3 -10 3 -10 0 -2 3 -115 3 1 2 
-2 4 1 15 1 -1 2 -15 -1 -10 1 -10 0 -2 -2 -3 -10 -10 15 1 3 3 2 4 4 -3 -15 15 0 -1 0 15 15 -2 3 -1 -15 1 -3 -10 1 -1 3 -3 -10 0 -10 1 -2 15 -1 -15 0 4 -2 1 -2 -15 15 -2 0 -3 0 0 1 -3 -15 1 -15 -1 -15 -2 -10 4 2 2 15 2 2 0 1 -10 -10 -10 -3 1 -2 -2 0 0 -10 -10 15 -2 3 1 15 0 3 0 
-15 -2 1 3 3 15 -2 -10 -3 -1 0 1 -3 1 15 -10 4 0 2 0 1 3 -3 -2 0 15 -15 1 15 0 15 -10 -3 1 15 -3 4 4 2 -2 -15 0 -2 4 0 -15 -10 -15 3 0 3 1 1 1 2 0 -2 4 0 -3 0 3 0 -1 -2 -1 0 -1 0 0 -15 4 1 -2 3 4 -2 -10 -2 15 0 -15 -2 0 0 0 -10 4 1 4 -1 -3 1 -3 15 -10 2 -3 0 -10 
1 2 -1 15 -15 -10 -1 2 -10 15 0 15 3 4 0 0 2 2 -10 0 -10 2 15 4 -3 15 3 4 1 -10 0 2 1 -3 0 -2 -2 -2 1 0 0 -2 2 -10 3 1 2 2 15 2 -3 4 4 -10 -10 3 1 2 -15 15 3 -15 3 2 0 -10 15 0 15 -10 0 -10 0 -15 -1 2 3 15 4 -10 -1 0 4 -10 -3 1 -10 0 0 -2 -3 3 3 2 -2 3 15 4 4 15 
1 3 3 -3 4 1 -3 -15 0 1 1 15 4 -3 -1 -10 3 -1 -2 1 -1 2 1 2 -1 -15 3 -15 1 0 3 0 3 -15 3 -1 -15 -10 -2 -1 0 0 -1 -10 0 -3 -15 -15 -15 -10 3 0 2 15 0 1 0 -2 -2 -1 -2 15 -3 -1 -3 -2 -3 -10 4 2 -1 0 -15 0 4 -3 1 3 15 -1 -15 -1 -3 3 -3 -1 3 4 0 0 -3 -3 -2 4 -1 4 -3 4 0 0 
-3 2 1 -2 -2 0 1 -2 4 -1 -15 2 3 15 1 -2 -1 -1 0 4 -15 -3 3 0 1 0 15 15 0 -15 -10 0 15 0 -3 -15 0 15 15 -2 3 -1 -15 -10 0 -3 -3 0 2 -2 1 4 15 0 -15 -15 3 -15 -2 -2 0 0 2 15 -2 -10 -2 3 -2 -2 0 0 -15 -2 0 4 -10 -2 15 -10 -15 -10 4 0 -2 -3 3 1 -3 1 -3 0 -3 -15 -1 -3 -2 3 -15 2 
-1 -3 3 -15 2 15 3 2 2 1 4 -1 -2 2 0 -1 -2 -10 4 2 -1 -1 -15 0 3 0 -3 3 3 -2 0 -2 -3 3 4 4 0 -10 -1 4 4 -10 -1 2 -1 -15 -15 0 -1 -3 15 2 2 4 -2 -3 0 -2 -2 0 -15 4 1 2 -2 -2 1 0 -2 -2 -2 4 15 2 0 2 4 0 -15 -15 0 1 1 3 -3 4 0 0 0 4 -3 -3 15 15 -10 -2 -15 3 1 2 
15 -10 1 -10 2 -10 0 3 -3 15 0 -15 -2 2 -2 -15 4 3 -1 -15 -2 -15 -15 1 0 -3 15 -1 -15 -15 4 4 15 4 2 -2 -10 -15 -3 -3 3 4 0 -3 15 0 0 2 -15 15 4 -10 1 -15 -1 15 15 -2 0 15 0 -1 3 0 -15 -1 1 -2 0 -3 0 -15 4 0 -15 1 15 -2 3 -3 -3 15 0 0 -3 -15 0 -15 -1 1 -2 1 4 1 -15 -2 1 3 0 4 
4 -15 -1 -15 15 0 0 -1 1 -15 0 -10 0 -2 4 4 15 15 -3 15 0 -10 -3 2 4 2 15 3 -10 2 15 -2 15 3 2 -3 3 1 -10 0 -15 15 4 -10 0 2 15 2 -3 -3 0 3 -2 4 -10 4 0 -2 -10 1 0 2 2 -15 -15 -10 -1 -1 0 3 -3 -10 -10 0 1 3 1 -10 -1 -2 0 0 1 -15 -3 -2 -1 -2 -1 3 -3 -15 4 -1 -10 -3 -2 3 0 -15 
0 15 -15 -2 3 0 -2 -10 -10 3 -15 -10 0 4 2 15 0 0 15 0 0 15 0 -2 1 -3 -3 3 -2 15 0 4 -10 -10 2 3 2 -10 -10 -3 -10 -3 0 -1 -3 -10 -10 0 4 15 4 -1 -2 15 -3 0 2 1 -2 2 -2 3 15 0 4 2 -1 1 2 1 -1 15 -2 2 2 0 4 -2 15 4 3 -10 2 0 3 15 0 -3 -2 -15 4 -10 -3 0 -3 0 15 4 -3 15 
0 -10 0 1 0 -2 -10 0 -2 15 4 0 -2 -10 -1 -10 0 -2 15 0 15 0 15 -1 -2 4 0 -1 -10 -10 -3 -3 -3 0 2 0 1 15 -1 -1 -15 0 1 4 -3 -15 -2 3 -1 -10 0 3 -2 -1 -10 1 -1 0 -10 -2 1 2 0 -2 -10 4 0 2 15 3 -10 -3 1 1 -1 -10 4 -3 0 1 15 15 4 0 1 -15 0 -10 2 -2 3 1 -1 -2 1 -1 0 15 -1 -1 
4 1 -10 -15 -3 -2 -1 -2 -15 -15 -15 0 15 0 -3 -3 -1 -15 0 2 2 15 0 4 -15 1 -3 -10 -3 -1 -3 3 -1 -2 -1 0 -2 4 -15 3 15 -2 1 3 -15 -3 -3 1 4 0 1 -2 1 2 4 -2 4 0 -2 -1 -1 2 0 -2 4 0 -15 2 2 1 15 2 4 4 -10 1 3 -10 2 -3 -10 -15 -10 -15 -1 -1 -10 0 0 -10 -1 2 -1 -2 -1 -2 2 0 -10 -2 
0 -1 3 0 -15 -2 -15 -3 -15 1 4 1 15 -2 -3 4 0 -10 -1 -10 2 -10 -2 -1 -3 2 15 -2 -2 -2 0 4 0 15 -10 1 3 1 15 -2 -1 0 1 -1 -1 15 -10 2 -1 -10 -3 -10 -3 0 -3 2 2 -3 3 -10 -10 0 15 3 1 -3 0 -1 3 3 3 -10 3 4 -10 -2 4 0 2 -3 4 2 2 -15 0 2 -3 4 -10 -2 -3 -3 0 15 -1 -10 -2 15 -2 -1 
